11111111111111111111
10000000000000000001
10C00C000C000C000001
111100000000000000E1
1P000000000011000001
11110000000000000001
11111111111111111111
